; 0
##########
#@$  .####
#$.$  ####
# $ ######
#  #######
#.########
#.########
##########
##########
##########

; 1
##########
##########
##########
##########
###  #####
## $ . $ #
##   $. @#
##    $. #
##.      #
##########
